10 09 04
    XXXXX
    X...X
    XJ..X
  XXX..JXX
  X..J.J.X
XXX.X.XX.X    XXXXX
X...X.XX.XXXXX..GGX
X.J..J..........GGX
XXXXX.XXX.XMXX..GGX
    X.....XXXXXXXXX
    XXXXXX
